|##   # b|
|# r  #  |
|     #  |
|  g  #  |
|        |
